XXXXXXX
X1HMH2X
X4HPHMX
XXXVXVX
  XVXVX
  X4H3X
  XXXXX